"filename", "language", "erb", "Ruby", "comment", "blank", "total"
"/workspaces/RiseNote/app/views/devise/confirmations/new.html.erb", "erb", 12, 0, 0, 5, 17
"/workspaces/RiseNote/app/views/devise/mailer/confirmation_instructions.html.erb", "erb", 3, 0, 0, 3, 6
"/workspaces/RiseNote/app/views/devise/mailer/email_changed.html.erb", "erb", 6, 0, 0, 2, 8
"/workspaces/RiseNote/app/views/devise/mailer/password_change.html.erb", "erb", 2, 0, 0, 2, 4
"/workspaces/RiseNote/app/views/devise/mailer/reset_password_instructions.html.erb", "erb", 5, 0, 0, 4, 9
"/workspaces/RiseNote/app/views/devise/mailer/unlock_instructions.html.erb", "erb", 4, 0, 0, 4, 8
"/workspaces/RiseNote/app/views/devise/passwords/edit.html.erb", "erb", 20, 0, 0, 6, 26
"/workspaces/RiseNote/app/views/devise/passwords/new.html.erb", "erb", 12, 0, 0, 5, 17
"/workspaces/RiseNote/app/views/devise/registrations/edit.html.erb", "erb", 30, 0, 0, 8, 38
"/workspaces/RiseNote/app/views/devise/registrations/new.html.erb", "erb", 30, 0, 0, 8, 38
"/workspaces/RiseNote/app/views/devise/sessions/new.html.erb", "erb", 25, 0, 0, 7, 32
"/workspaces/RiseNote/app/views/devise/shared/_error_messages.html.erb", "erb", 15, 0, 0, 1, 16
"/workspaces/RiseNote/app/views/devise/shared/_links.html.erb", "erb", 20, 0, 0, 6, 26
"/workspaces/RiseNote/app/views/devise/unlocks/new.html.erb", "erb", 12, 0, 0, 5, 17
"/workspaces/RiseNote/app/views/folders/index.html.erb", "erb", 52, 0, 0, 9, 61
"/workspaces/RiseNote/app/views/folders/new.html.erb", "erb", 0, 0, 0, 1, 1
"/workspaces/RiseNote/app/views/hello/index.html.erb", "erb", 1, 0, 0, 1, 2
"/workspaces/RiseNote/app/views/home/index.html.erb", "erb", 22, 0, 0, 3, 25
"/workspaces/RiseNote/app/views/layouts/application.html.erb", "erb", 39, 0, 0, 6, 45
"/workspaces/RiseNote/app/views/layouts/mailer.html.erb", "erb", 12, 0, 0, 2, 14
"/workspaces/RiseNote/app/views/layouts/mailer.text.erb", "erb", 1, 0, 0, 1, 2
"/workspaces/RiseNote/app/views/learning_records/show.html.erb", "erb", 5, 0, 0, 5, 10
"/workspaces/RiseNote/app/views/memos/_form.html.erb", "erb", 54, 0, 0, 11, 65
"/workspaces/RiseNote/app/views/memos/edit.html.erb", "erb", 1, 0, 0, 0, 1
"/workspaces/RiseNote/app/views/memos/index.html.erb", "erb", 49, 0, 0, 9, 58
"/workspaces/RiseNote/app/views/memos/new.html.erb", "erb", 1, 0, 0, 0, 1
"/workspaces/RiseNote/app/views/memos/show.html.erb", "erb", 13, 0, 0, 3, 16
"/workspaces/RiseNote/app/views/missions/index.html.erb", "erb", 25, 0, 0, 2, 27
"/workspaces/RiseNote/app/views/posts/index.html.erb", "erb", 50, 0, 0, 4, 54
"/workspaces/RiseNote/app/views/posts/new.html.erb", "erb", 55, 0, 0, 10, 65
"/workspaces/RiseNote/app/views/posts/show.html.erb", "erb", 63, 0, 0, 8, 71
"/workspaces/RiseNote/app/views/shared/_accounts.html.erb", "erb", 5, 0, 0, 0, 5
"/workspaces/RiseNote/app/views/shared/_contextMenu.html.erb", "erb", 11, 0, 0, 1, 12
"/workspaces/RiseNote/app/views/shared/_missionList.html.erb", "erb", 29, 0, 0, 2, 31
"/workspaces/RiseNote/app/views/shared/_mypage.html.erb", "erb", 27, 0, 0, 1, 28
"/workspaces/RiseNote/app/views/shared/_navbar.html.erb", "erb", 46, 0, 0, 10, 56
"/workspaces/RiseNote/app/views/tags/index.html.erb", "erb", 39, 0, 0, 2, 41
"/workspaces/RiseNote/app/views/users/index.html.erb", "erb", 44, 0, 0, 6, 50
"/workspaces/RiseNote/app/views/users/show.html.erb", "erb", 56, 0, 0, 8, 64
"/workspaces/RiseNote/config/application.rb", "Ruby", 0, -19, 0, -5, -24
"/workspaces/RiseNote/config/boot.rb", "Ruby", 0, -3, 0, -2, -5
"/workspaces/RiseNote/config/environment.rb", "Ruby", 0, -4, 0, -2, -6
"/workspaces/RiseNote/config/environments/development.rb", "Ruby", 0, -60, 0, -25, -85
"/workspaces/RiseNote/config/environments/production.rb", "Ruby", 0, -68, 0, -26, -94
"/workspaces/RiseNote/config/environments/test.rb", "Ruby", 0, -44, 0, -17, -61
"/workspaces/RiseNote/config/importmap.rb", "Ruby", 0, -9, 0, -2, -11
"/workspaces/RiseNote/config/initializers/assets.rb", "Ruby", 0, -10, 0, -3, -13
"/workspaces/RiseNote/config/initializers/content_security_policy.rb", "Ruby", 0, -23, 0, -3, -26
"/workspaces/RiseNote/config/initializers/devise.rb", "Ruby", 0, -259, 0, -55, -314
"/workspaces/RiseNote/config/initializers/filter_parameter_logging.rb", "Ruby", 0, -7, 0, -2, -9
"/workspaces/RiseNote/config/initializers/inflections.rb", "Ruby", 0, -14, 0, -3, -17
"/workspaces/RiseNote/config/initializers/permissions_policy.rb", "Ruby", 0, -11, 0, -1, -12
"/workspaces/RiseNote/config/puma.rb", "Ruby", 0, -36, 0, -8, -44
"/workspaces/RiseNote/config/routes.rb", "Ruby", 0, -34, 0, -10, -44
"Total", "-", 896, -601, 0, 7, 302